La riqueza de las naciones - Adam Smith
El capital - Karl Marx
Teoría general del empleo, el interés y el dinero - John Maynard Keynes
Economía para Dummies - Tracy Brown
Teoría y política económica - Joseph Stiglitz
Repensar la pobreza - Abhijit Banerjee y Esther Duflo
La economía del bien común - Luigino Bruni y Stefano Zamagni
Capital e ideología - Thomas Piketty
Freakonomics - Steven Levitt y Stephen Dubner
Mi primer libro de economía, ahorro e inversión - Juan Carlos Martínez
Economía básica: Un manual de economía escrito desde el sentido común - Thomas Sowell
Historia del análisis económico - Mark Blaug
El triunfo del dinero: Cómo las finanzas mueven el mundo - Peter L. Bernstein
El capital en el siglo XXI - Thomas Piketty
Economía básica. Claves para comprender la economía - Thomas Sowell
El precio de la desigualdad - Thomas Piketty
Economía para el 99% de la población - Ha-Joon Chang
El libro prohibido de la economía - Todd Buchholz
Economía sin corbata: Conversaciones con mi hija - Eduardo Suplicy
La psicología del dinero - Paco Underhill
El arte de invertir - Benjamin Graham
Economía báscia: Un manual de economía escrito desde el sentido común - Thomas Sowell
El economista callejero - Tyler Cowen
El libro de la economía - N. Gregory Mankiw
Capitalismo y democracia en el siglo XXI: nuevas tendencias y nuevos destinos - Luis de Sebastián
Capitalismo, nada más - Branko Milanovic
Capitalismo Sugar Daddy - Peter Fleming
El trasfondo económico de la historia del siglo XX - Jeffry Frieden
La economía del bienestar - Richard Layard
El futuro del capitalismo - Paul Collier